Yamba : accueillir chaleureusement

Fâa : couper, tuer, traverser

Kanivöo : caniveau

Sâkigarâme : kilogramme
Sâkimêtere : kilométre
Sîgî mbîrîmbîrî : être positif
Sîgî vâkâvaka : être négatif
Yongôro : long
Gbâzâ : cercle
Lêndo : aire
Wanguru : athléte
Kugbë(nginza) : billet(argent)
Kônde : calcul
Kamâ : bord
Karëe : carré
Kötägbâ : carton
Garâme-fângbangbo : centigramme
Lîtiri-fâsâki : centilitre
Tûku : citerne
Kâpâ,längö : date
Sêgbâ : densité
Limo : dessin
Kângbi : division
Lêngbi : égalité
Nîngä : durée
Bata : économiser
Gbâzâbêsêse : équateur
Täpandë : exemple
Waranginza : gain
Tuke : inverser
Tîa : manquer
Kôto : million
Meka : noter
Hini : peindre
Leke : poser
Penze : segment
Lando : stade
Zuda : vide
Sana : tourner
Lingêre : tarif
Kpongbo,taboro : tableau
Fâyângbangbo : pourcentage
Köpörö : pièce monnaie
A yèkè ngangu pèpè: C'est facile

Sé(ex ; yoro sô a sé mingi) : Bitter
Mba koro : Ancient
Kpéngba-lè : Attentive
Kion : Miserly
Waziba : Blind
Wa-Kpèrè Kpèrè(ou) Sakpa-tènè : Talkative
Nduru : Brief
Kuru : Rough,brutal
Vuru : Bright, white
A yèkè na ngia : Happy
Wa kpengbango-bè : courageous
Ndé : Different
Ngangu(ou kpéngba) : Difficult
Mbirimbiri : Right
Verb to be: Yèkè
Mbi yèkè na kobéla : I am sick.
Mbi yèkè Centrafricain : I am Central African.
Mbi yèkè na mapa(ou) Mapa a yèkè na mbi : I have a bread.
Mapa a yèkè na mbi pèpè : They are three in the house.
Ala yèkè na yâ ti da otä : He is the leader of this village.
Ïrï tî këkë sô nyen ? : What is the name of this tree?
Lo gä kötä awe. : He became great.
To have: Yèkè
Mbi yèkè na nginza. : I also money.
Lo wara nginza mîngi. : He won a lot of money.
Ba : To look – to see

Ba môsuma : To dream

Balao : To greet

Bata : To look after-to invigilate-to Protect

Bi : To throw

Bungbi : To assemble-to gather-to groupe

Dèkongo : To shout

Diko : To count-to read-to tell

Do : To tremble

Do do : To dance

Du : To give birth-to Produce-to give

Duti : To stay-to live-to sit

Fa : To cut down-to to cut--Enseigner-Monter

Fu : To Cut-to Pillar- to Servir

Futa : To Pay-to Liquid

Ga : To Come

Gbanzi : To Prevent-to Defend-to Ban

Gbi : To Burn

Gbo : To Sweep- to Picking

Gbongu : To Swim-to bathe

Gboto : To Sort-to tan

Gbu : To hold-to Grab

Gilisa : To Lose-to Forget

Gué : To Go-to Bring-to Carry

Yèkè : To Be-to have

Sala mbèti : To write

Téné : To speak